........................................
........................................
.....$$$$$####.................@@##.....
.....$$$$$####.................@@##.....
%%%%%%%%%%%%%%%%%%%%%%%%%......@@##.....
%%%%%%%%%%%%%%%%%%%%%%%%%######@@##.....
#####...........######.........@@##.....
........................................
....@@@@@@..@@@@@@@@@@@@@@..@@@@@@@@....
....@%%%%%%%%%%%%%%%%%%%%%%%%%%%%%%.....
....@%.........#####.....#####....%@....
....@%.........#####.....#####....%.....
.##..%.#####......................%@....
.##..%.#####...$$$$$$$$...........%@....
.##.@%.#####...$$$$$$$$...........%@..#.
.....%.#####...$$$$$$$$...........%#..#.
....@%.........$$$$$$$$...........%#..#.
....@%.........########....###....%@.##.
.##.@%.........########....###....%#.##.
.##..%.....................###....%@....
....@%..#####..............###....%@....
.....%..#####.....................%.###.
....@%.............####...........%@.##.
..#.@%............................%@.##.
..#.@%%%%%%%%%%%%%%%%%%%%%%%%%%%%%%@....
..#.@@@..@.@.@@@@@@@@@@@@@@@@@@.@@@@....
......................................@.
%%%%%%%%%%%%%%%%%%%%%%%%%%%%%%%%%%%%..@.
........######$$$$$$#######....#@@....@.
........................................
