........................................
........................................
..$$..##..##..@@..%%%%%.@@@@.%%%%%......
..$$..##..##..@@..%%%%%.@@@@.%%%%%......
..$$..##..##..@@..%%%%%.@@@@.%%%%%......
..$$..##..##..@@..%%%%%.@@@@.%%%%%......
..##..##..##..@@..%%%%%.@@@@.%%%%%....##
..##..##..##..@@..%%%%%.@@@@.%%%%%......
..##..##..##..@@..%%%%%.@@@@.%%%%%......
..%%..##..........%%%%%.@@@@.%%%%%......
..%%..##..........%%%%%.@@@@.%%%%%...###
..........##..##........................
##..#.......%%%%%%%%%%%%%%%%%%%%%%%%%%%%
##..#.......%%%%%%%%%%%%%%%%%%%%%%%%%%%%
##..#.......%%%%%%%%%%%%%%%%%%%%%%%%%%%%
##..#.......%%%%%%%%%%%%%%%%%%%%%%%#####
##..#.......%%%%%%%%%%%%%%%%%%%%%%%#####
##..#.......%%%%%%%%%%%%%%%%%%%%%%%#####
##..#.......%%%%%%%%%%%%%%%%%%%%%%%#####
##..#.......%%%%%%%%%%%%%%%%%%%%%%%#####
##..#.......%%%%%%%%%%%%%%%%%%%%%%%#####
##..#.......%%%%%%%%%%%%%%%%%%%%%%%#####
##..#.............####..##...#########..
....#.............####..................
$$$$$$$$$$$$$$$$$$$$$$$#####.#########..
$$$$$$$$$$$$$$$$$$$$$$$#####............
.......%%%........##..##.....#########..
.......%%%........##..##................
.......%%%..............................
........................................
